EEEEEEEEEEEEPPPEEEEEEEE
EEEEEEEEEEEEPEPEEEEEEEE
EEPPPEEEEEEEPEPEEEEEEEE
EEPEPEEEEEEEPEPPPPEEEEE
EEPEPEEEEEEEPEEEEPEEEEE
EEPEPEEEPPPPPEPPPPEEEEE
PPPEPEEEPEEEEEPEEEEEEEE
EEEEPEEEPEEEEEPPPPPPPPP
EEEEPPPPPEEEEEEEEEEEEEE